NO ../textures/north.xpm

SO ../textures/south.xpm

   C   42  , 3, 5

WE ../textures/west.xpm

EA ../textures/east.xpm
 
     F    220,  100  ,  3
        111111111111111111111111
        100000000011000000000000
        101100000111000000000000
        10010000000000000S000000
11111111101100000111000000000000
10000000011000000110011111111111
11110111111111011111000010001
11110111111111011101010010001
11000000110101011100000000001
10000000000000001100010010001
10000000000000001101010010001
11000001110101011111011110111
11111111 1110101 101111010001
1111 111 1111111 111111111111