    WE ./path_to_the_west_texture
F    220,  100  ,  3
   SO         ./path_to_the_south_texture
   C   42  ,   3,   5
             NO      ./path_to_the_north_texture
        EA ./path_to_the_east_texture
 
 
        1111111111111111111111111   
        1000000000110000000000001
        1011000001110000000000001
        1001000000000000010000001       111111111111111111111111111
111111111011000001110000000000001       100000000000000000000000001 
100000000110000001100111111111111       100000000000000000000000001
11110111111111011111000010001           1000N0000000000011111100001
11110111111111011101010010001           100000000000000010000100001
11000000110101011100000000001           100000000000000011111111111
10000000000000001100010010001           111111111111111111111111111
10000000000000001101010010001
11000001110101011111011110111
11111111 1110101 101111010001
1111 111 1111111 111111111111