NO textures/north.xpm
SO textures/south.xpm
WE textures/west.xpm
EA textures/east.xpm

   C 75, 75, 255
   F 50, 50, 50

111111111111111111111111
100000000000000000000001
100000000000000000000001
101010101010101010100001
101212101212101212100001
101010101010101010100001
100000000000000000000001
100000000000000000000001
100000000000000000000001
100000000000000000000001
1000000000S0000000000001
100000000000000000000001
100000000000000000000001
103030300000025152000001
100000000000055155000001
103040300000011111000001
100000000000055155000001
103030300000025152000001
100000000000000000000001
100000000000000000000001
100000000000000000000001
100000000000000000000001
100000000000005555555551
111111111111111111111111