NO textures/north.xpm
SO textures/south.xpm
WE textures/west.xpm
EA textures/east.xpm

   C 75, 75, 255
   F 50, 50, 50

111111
100S11
111111